Feature ID	Taxon
Mockrobiota_208	k__Bacteria; p__Firmicutes; c__Clostridia; o__Eubacteriales; f__Clostridiaceae; g__Clostridium-Clostridium_sensu_stricto_1; s__Clostridium_beijerinckii-sensu
Mockrobiota_16	k__Bacteria; p__Firmicutes; c__Clostridia; o__Eubacteriales; f__Clostridiaceae; g__Clostridium-Clostridium_sensu_stricto_1; s__Clostridium_beijerinckii-sensu
Mockrobiota_19	k__Bacteria; p__Firmicutes; c__Clostridia; o__Eubacteriales; f__Clostridiaceae; g__Clostridium-Clostridium_sensu_stricto_1; s__Clostridium_beijerinckii-sensu
Mockrobiota_22	k__Bacteria; p__Firmicutes; c__Clostridia; o__Eubacteriales; f__Clostridiaceae; g__Clostridium-Clostridium_sensu_stricto_1; s__Clostridium_beijerinckii-sensu
Mockrobiota_17	k__Bacteria; p__Firmicutes; c__Clostridia; o__Eubacteriales; f__Clostridiaceae; g__Clostridium-Clostridium_sensu_stricto_1; s__Clostridium_beijerinckii-sensu
Mockrobiota_205	k__Bacteria; p__Firmicutes; c__Clostridia; o__Eubacteriales; f__Clostridiaceae; g__Clostridium-Clostridium_sensu_stricto_1; s__Clostridium_beijerinckii-sensu
Mockrobiota_13	k__Bacteria; p__Firmicutes; c__Clostridia; o__Eubacteriales; f__Clostridiaceae; g__Clostridium-Clostridium_sensu_stricto_1; s__Clostridium_beijerinckii-sensu
Mockrobiota_14	k__Bacteria; p__Firmicutes; c__Clostridia; o__Eubacteriales; f__Clostridiaceae; g__Clostridium-Clostridium_sensu_stricto_1; s__Clostridium_beijerinckii-sensu
Mockrobiota_21	k__Bacteria; p__Firmicutes; c__Clostridia; o__Eubacteriales; f__Clostridiaceae; g__Clostridium-Clostridium_sensu_stricto_1; s__Clostridium_beijerinckii-sensu
Mockrobiota_24	k__Bacteria; p__Firmicutes; c__Clostridia; o__Eubacteriales; f__Clostridiaceae; g__Clostridium-Clostridium_sensu_stricto_1; s__Clostridium_beijerinckii-sensu
Mockrobiota_212	k__Bacteria; p__Firmicutes; c__Clostridia; o__Eubacteriales; f__Clostridiaceae; g__Clostridium-Clostridium_sensu_stricto_1; s__Clostridium_beijerinckii-sensu
Mockrobiota_200	k__Bacteria; p__Firmicutes; c__Clostridia; o__Eubacteriales; f__Clostridiaceae; g__Clostridium-Clostridium_sensu_stricto_1; s__Clostridium_beijerinckii-sensu
Mockrobiota_23	k__Bacteria; p__Firmicutes; c__Clostridia; o__Eubacteriales; f__Clostridiaceae; g__Clostridium-Clostridium_sensu_stricto_1; s__Clostridium_beijerinckii-sensu
Mockrobiota_201	k__Bacteria; p__Firmicutes; c__Clostridia; o__Eubacteriales; f__Clostridiaceae; g__Clostridium-Clostridium_sensu_stricto_1; s__Clostridium_beijerinckii-sensu
Mockrobiota_209	k__Bacteria; p__Firmicutes; c__Clostridia; o__Eubacteriales; f__Clostridiaceae; g__Clostridium-Clostridium_sensu_stricto_1; s__Clostridium_beijerinckii-sensu
Mockrobiota_20	k__Bacteria; p__Firmicutes; c__Clostridia; o__Eubacteriales; f__Clostridiaceae; g__Clostridium-Clostridium_sensu_stricto_1; s__Clostridium_beijerinckii-sensu
Mockrobiota_210	k__Bacteria; p__Firmicutes; c__Clostridia; o__Eubacteriales; f__Clostridiaceae; g__Clostridium-Clostridium_sensu_stricto_1; s__Clostridium_beijerinckii-sensu
Mockrobiota_204	k__Bacteria; p__Firmicutes; c__Clostridia; o__Eubacteriales; f__Clostridiaceae; g__Clostridium-Clostridium_sensu_stricto_1; s__Clostridium_beijerinckii-sensu
Mockrobiota_202	k__Bacteria; p__Firmicutes; c__Clostridia; o__Eubacteriales; f__Clostridiaceae; g__Clostridium-Clostridium_sensu_stricto_1; s__Clostridium_beijerinckii-sensu
Mockrobiota_207	k__Bacteria; p__Firmicutes; c__Clostridia; o__Eubacteriales; f__Clostridiaceae; g__Clostridium-Clostridium_sensu_stricto_1; s__Clostridium_beijerinckii-sensu
Mockrobiota_203	k__Bacteria; p__Firmicutes; c__Clostridia; o__Eubacteriales; f__Clostridiaceae; g__Clostridium-Clostridium_sensu_stricto_1; s__Clostridium_beijerinckii-sensu
Mockrobiota_26	k__Bacteria; p__Firmicutes; c__Clostridia; o__Eubacteriales; f__Clostridiaceae; g__Clostridium-Clostridium_sensu_stricto_1; s__Clostridium_beijerinckii-sensu
Mockrobiota_206	k__Bacteria; p__Firmicutes; c__Clostridia; o__Eubacteriales; f__Clostridiaceae; g__Clostridium-Clostridium_sensu_stricto_1; s__Clostridium_beijerinckii-sensu
Mockrobiota_18	k__Bacteria; p__Firmicutes; c__Clostridia; o__Eubacteriales; f__Clostridiaceae; g__Clostridium-Clostridium_sensu_stricto_1; s__Clostridium_beijerinckii-sensu
Mockrobiota_199	k__Bacteria; p__Firmicutes; c__Clostridia; o__Eubacteriales; f__Clostridiaceae; g__Clostridium-Clostridium_sensu_stricto_1; s__Clostridium_beijerinckii-sensu
Mockrobiota_211	k__Bacteria; p__Firmicutes; c__Clostridia; o__Eubacteriales; f__Clostridiaceae; g__Clostridium-Clostridium_sensu_stricto_1; s__Clostridium_beijerinckii-sensu
Mockrobiota_25	k__Bacteria; p__Firmicutes; c__Clostridia; o__Eubacteriales; f__Clostridiaceae; g__Clostridium-Clostridium_sensu_stricto_1; s__Clostridium_beijerinckii-sensu
Mockrobiota_15	k__Bacteria; p__Firmicutes; c__Clostridia; o__Eubacteriales; f__Clostridiaceae; g__Clostridium-Clostridium_sensu_stricto_1; s__Clostridium_beijerinckii-sensu
Mockrobiota_260	k__Bacteria; p__Bacteroidetes; c__Bacteroidia; o__Bacteroidales; f__Bacteroidaceae; g__Phocaeicola; s__Phocaeicola_vulgatus
Mockrobiota_198	k__Bacteria; p__Bacteroidetes; c__Bacteroidia; o__Bacteroidales; f__Bacteroidaceae; g__Phocaeicola; s__Phocaeicola_vulgatus
Mockrobiota_12	k__Bacteria; p__Bacteroidetes; c__Bacteroidia; o__Bacteroidales; f__Bacteroidaceae; g__Phocaeicola; s__Phocaeicola_vulgatus
Mockrobiota_9	k__Bacteria; p__Bacteroidetes; c__Bacteroidia; o__Bacteroidales; f__Bacteroidaceae; g__Phocaeicola; s__Phocaeicola_vulgatus
Mockrobiota_194	k__Bacteria; p__Bacteroidetes; c__Bacteroidia; o__Bacteroidales; f__Bacteroidaceae; g__Phocaeicola; s__Phocaeicola_vulgatus
Mockrobiota_7	k__Bacteria; p__Bacteroidetes; c__Bacteroidia; o__Bacteroidales; f__Bacteroidaceae; g__Phocaeicola; s__Phocaeicola_vulgatus
Mockrobiota_65	k__Bacteria; p__Bacteroidetes; c__Bacteroidia; o__Bacteroidales; f__Bacteroidaceae; g__Phocaeicola; s__Phocaeicola_vulgatus
Mockrobiota_66	k__Bacteria; p__Bacteroidetes; c__Bacteroidia; o__Bacteroidales; f__Bacteroidaceae; g__Phocaeicola; s__Phocaeicola_vulgatus
Mockrobiota_10	k__Bacteria; p__Bacteroidetes; c__Bacteroidia; o__Bacteroidales; f__Bacteroidaceae; g__Phocaeicola; s__Phocaeicola_vulgatus
Mockrobiota_68	k__Bacteria; p__Bacteroidetes; c__Bacteroidia; o__Bacteroidales; f__Bacteroidaceae; g__Phocaeicola; s__Phocaeicola_vulgatus
Mockrobiota_195	k__Bacteria; p__Bacteroidetes; c__Bacteroidia; o__Bacteroidales; f__Bacteroidaceae; g__Phocaeicola; s__Phocaeicola_vulgatus
Mockrobiota_67	k__Bacteria; p__Bacteroidetes; c__Bacteroidia; o__Bacteroidales; f__Bacteroidaceae; g__Phocaeicola; s__Phocaeicola_vulgatus
Mockrobiota_197	k__Bacteria; p__Bacteroidetes; c__Bacteroidia; o__Bacteroidales; f__Bacteroidaceae; g__Phocaeicola; s__Phocaeicola_vulgatus
Mockrobiota_193	k__Bacteria; p__Bacteroidetes; c__Bacteroidia; o__Bacteroidales; f__Bacteroidaceae; g__Phocaeicola; s__Phocaeicola_vulgatus
Mockrobiota_8	k__Bacteria; p__Bacteroidetes; c__Bacteroidia; o__Bacteroidales; f__Bacteroidaceae; g__Phocaeicola; s__Phocaeicola_vulgatus
Mockrobiota_11	k__Bacteria; p__Bacteroidetes; c__Bacteroidia; o__Bacteroidales; f__Bacteroidaceae; g__Phocaeicola; s__Phocaeicola_vulgatus
Mockrobiota_196	k__Bacteria; p__Bacteroidetes; c__Bacteroidia; o__Bacteroidales; f__Bacteroidaceae; g__Phocaeicola; s__Phocaeicola_vulgatus
Mockrobiota_47	k__Bacteria; p__Firmicutes; c__Bacilli; o__Bacillales; f__Staphylococcaceae; g__Staphylococcus; s__Staphylococcus_aureus-epidermidis
Mockrobiota_49	k__Bacteria; p__Firmicutes; c__Bacilli; o__Bacillales; f__Staphylococcaceae; g__Staphylococcus; s__Staphylococcus_aureus-epidermidis
Mockrobiota_237	k__Bacteria; p__Firmicutes; c__Bacilli; o__Bacillales; f__Staphylococcaceae; g__Staphylococcus; s__Staphylococcus_aureus-epidermidis
Mockrobiota_241	k__Bacteria; p__Firmicutes; c__Bacilli; o__Bacillales; f__Staphylococcaceae; g__Staphylococcus; s__Staphylococcus_aureus-epidermidis
Mockrobiota_45	k__Bacteria; p__Firmicutes; c__Bacilli; o__Bacillales; f__Staphylococcaceae; g__Staphylococcus; s__Staphylococcus_aureus-epidermidis
Mockrobiota_42	k__Bacteria; p__Firmicutes; c__Bacilli; o__Bacillales; f__Staphylococcaceae; g__Staphylococcus; s__Staphylococcus_aureus-epidermidis
Mockrobiota_48	k__Bacteria; p__Firmicutes; c__Bacilli; o__Bacillales; f__Staphylococcaceae; g__Staphylococcus; s__Staphylococcus_aureus-epidermidis
Mockrobiota_43	k__Bacteria; p__Firmicutes; c__Bacilli; o__Bacillales; f__Staphylococcaceae; g__Staphylococcus; s__Staphylococcus_aureus-epidermidis
Mockrobiota_240	k__Bacteria; p__Firmicutes; c__Bacilli; o__Bacillales; f__Staphylococcaceae; g__Staphylococcus; s__Staphylococcus_aureus-epidermidis
Mockrobiota_239	k__Bacteria; p__Firmicutes; c__Bacilli; o__Bacillales; f__Staphylococcaceae; g__Staphylococcus; s__Staphylococcus_aureus-epidermidis
Mockrobiota_243	k__Bacteria; p__Firmicutes; c__Bacilli; o__Bacillales; f__Staphylococcaceae; g__Staphylococcus; s__Staphylococcus_aureus-epidermidis
Mockrobiota_46	k__Bacteria; p__Firmicutes; c__Bacilli; o__Bacillales; f__Staphylococcaceae; g__Staphylococcus; s__Staphylococcus_aureus-epidermidis
Mockrobiota_238	k__Bacteria; p__Firmicutes; c__Bacilli; o__Bacillales; f__Staphylococcaceae; g__Staphylococcus; s__Staphylococcus_aureus-epidermidis
Mockrobiota_242	k__Bacteria; p__Firmicutes; c__Bacilli; o__Bacillales; f__Staphylococcaceae; g__Staphylococcus; s__Staphylococcus_aureus-epidermidis
Mockrobiota_44	k__Bacteria; p__Firmicutes; c__Bacilli; o__Bacillales; f__Staphylococcaceae; g__Staphylococcus; s__Staphylococcus_aureus-epidermidis
Mockrobiota_169	k__Bacteria; p__Proteobacteria; c__Gammaproteobacteria; o__Alteromonadales; f__Shewanellaceae; g__Shewanella; s__Shewanella_baltica
Mockrobiota_173	k__Bacteria; p__Proteobacteria; c__Gammaproteobacteria; o__Alteromonadales; f__Shewanellaceae; g__Shewanella; s__Shewanella_baltica
Mockrobiota_165	k__Bacteria; p__Proteobacteria; c__Gammaproteobacteria; o__Alteromonadales; f__Shewanellaceae; g__Shewanella; s__Shewanella_baltica
Mockrobiota_168	k__Bacteria; p__Proteobacteria; c__Gammaproteobacteria; o__Alteromonadales; f__Shewanellaceae; g__Shewanella; s__Shewanella_baltica
Mockrobiota_166	k__Bacteria; p__Proteobacteria; c__Gammaproteobacteria; o__Alteromonadales; f__Shewanellaceae; g__Shewanella; s__Shewanella_baltica
Mockrobiota_162	k__Bacteria; p__Proteobacteria; c__Gammaproteobacteria; o__Alteromonadales; f__Shewanellaceae; g__Shewanella; s__Shewanella_baltica
Mockrobiota_170	k__Bacteria; p__Proteobacteria; c__Gammaproteobacteria; o__Alteromonadales; f__Shewanellaceae; g__Shewanella; s__Shewanella_baltica
Mockrobiota_167	k__Bacteria; p__Proteobacteria; c__Gammaproteobacteria; o__Alteromonadales; f__Shewanellaceae; g__Shewanella; s__Shewanella_baltica
Mockrobiota_175	k__Bacteria; p__Proteobacteria; c__Gammaproteobacteria; o__Alteromonadales; f__Shewanellaceae; g__Shewanella; s__Shewanella_baltica
Mockrobiota_176	k__Bacteria; p__Proteobacteria; c__Gammaproteobacteria; o__Alteromonadales; f__Shewanellaceae; g__Shewanella; s__Shewanella_baltica
Mockrobiota_164	k__Bacteria; p__Proteobacteria; c__Gammaproteobacteria; o__Alteromonadales; f__Shewanellaceae; g__Shewanella; s__Shewanella_baltica
Mockrobiota_172	k__Bacteria; p__Proteobacteria; c__Gammaproteobacteria; o__Alteromonadales; f__Shewanellaceae; g__Shewanella; s__Shewanella_baltica
Mockrobiota_174	k__Bacteria; p__Proteobacteria; c__Gammaproteobacteria; o__Alteromonadales; f__Shewanellaceae; g__Shewanella; s__Shewanella_baltica
Mockrobiota_171	k__Bacteria; p__Proteobacteria; c__Gammaproteobacteria; o__Alteromonadales; f__Shewanellaceae; g__Shewanella; s__Shewanella_baltica
Mockrobiota_163	k__Bacteria; p__Proteobacteria; c__Gammaproteobacteria; o__Alteromonadales; f__Shewanellaceae; g__Shewanella; s__Shewanella_baltica
Mockrobiota_2	k__Bacteria; p__Firmicutes; c__Bacilli; o__Bacillales; f__Bacillaceae; g__Bacillus; s__Bacillus_cereus
Mockrobiota_3	k__Bacteria; p__Firmicutes; c__Bacilli; o__Bacillales; f__Bacillaceae; g__Bacillus; s__Bacillus_cereus
Mockrobiota_5	k__Bacteria; p__Firmicutes; c__Bacilli; o__Bacillales; f__Bacillaceae; g__Bacillus; s__Bacillus_cereus
Mockrobiota_6	k__Bacteria; p__Firmicutes; c__Bacilli; o__Bacillales; f__Bacillaceae; g__Bacillus; s__Bacillus_cereus
Mockrobiota_189	k__Bacteria; p__Firmicutes; c__Bacilli; o__Bacillales; f__Bacillaceae; g__Bacillus; s__Bacillus_cereus
Mockrobiota_192	k__Bacteria; p__Firmicutes; c__Bacilli; o__Bacillales; f__Bacillaceae; g__Bacillus; s__Bacillus_cereus
Mockrobiota_4	k__Bacteria; p__Firmicutes; c__Bacilli; o__Bacillales; f__Bacillaceae; g__Bacillus; s__Bacillus_cereus
Mockrobiota_190	k__Bacteria; p__Firmicutes; c__Bacilli; o__Bacillales; f__Bacillaceae; g__Bacillus; s__Bacillus_cereus
Mockrobiota_191	k__Bacteria; p__Firmicutes; c__Bacilli; o__Bacillales; f__Bacillaceae; g__Bacillus; s__Bacillus_cereus
Mockrobiota_219	k__Bacteria; p__Proteobacteria; c__Gammaproteobacteria; o__Enterobacterales; f__Enterobacteriaceae; g__Escherichia-Escherichia-Shigella; s__Escherichia-Shigella_coli:Escherichia_coli
Mockrobiota_217	k__Bacteria; p__Proteobacteria; c__Gammaproteobacteria; o__Enterobacterales; f__Enterobacteriaceae; g__Escherichia-Escherichia-Shigella; s__Escherichia-Shigella_coli:Escherichia_coli
Mockrobiota_31	k__Bacteria; p__Proteobacteria; c__Gammaproteobacteria; o__Enterobacterales; f__Enterobacteriaceae; g__Escherichia-Escherichia-Shigella; s__Escherichia-Shigella_coli:Escherichia_coli
Mockrobiota_261	k__Bacteria; p__Proteobacteria; c__Gammaproteobacteria; o__Enterobacterales; f__Enterobacteriaceae; g__Escherichia-Escherichia-Shigella; s__Escherichia-Shigella_coli:Escherichia_coli
Mockrobiota_221	k__Bacteria; p__Proteobacteria; c__Gammaproteobacteria; o__Enterobacterales; f__Enterobacteriaceae; g__Escherichia-Escherichia-Shigella; s__Escherichia-Shigella_coli:Escherichia_coli
Mockrobiota_220	k__Bacteria; p__Proteobacteria; c__Gammaproteobacteria; o__Enterobacterales; f__Enterobacteriaceae; g__Escherichia-Escherichia-Shigella; s__Escherichia-Shigella_coli:Escherichia_coli
Mockrobiota_222	k__Bacteria; p__Proteobacteria; c__Gammaproteobacteria; o__Enterobacterales; f__Enterobacteriaceae; g__Escherichia-Escherichia-Shigella; s__Escherichia-Shigella_coli:Escherichia_coli
Mockrobiota_218	k__Bacteria; p__Proteobacteria; c__Gammaproteobacteria; o__Enterobacterales; f__Enterobacteriaceae; g__Escherichia-Escherichia-Shigella; s__Escherichia-Shigella_coli:Escherichia_coli
Mockrobiota_56	k__Bacteria; p__Firmicutes; c__Bacilli; o__Bacillales; f__Listeriaceae; g__Listeria; s__Listeria_monocytogenes
Mockrobiota_57	k__Bacteria; p__Firmicutes; c__Bacilli; o__Bacillales; f__Listeriaceae; g__Listeria; s__Listeria_monocytogenes
Mockrobiota_225	k__Bacteria; p__Firmicutes; c__Bacilli; o__Bacillales; f__Listeriaceae; g__Listeria; s__Listeria_monocytogenes
Mockrobiota_228	k__Bacteria; p__Firmicutes; c__Bacilli; o__Bacillales; f__Listeriaceae; g__Listeria; s__Listeria_monocytogenes
Mockrobiota_59	k__Bacteria; p__Firmicutes; c__Bacilli; o__Bacillales; f__Listeriaceae; g__Listeria; s__Listeria_monocytogenes
Mockrobiota_58	k__Bacteria; p__Firmicutes; c__Bacilli; o__Bacillales; f__Listeriaceae; g__Listeria; s__Listeria_monocytogenes
Mockrobiota_227	k__Bacteria; p__Firmicutes; c__Bacilli; o__Bacillales; f__Listeriaceae; g__Listeria; s__Listeria_monocytogenes
Mockrobiota_226	k__Bacteria; p__Firmicutes; c__Bacilli; o__Bacillales; f__Listeriaceae; g__Listeria; s__Listeria_monocytogenes
Mockrobiota_129	k__Bacteria; p__Firmicutes; c__Bacilli; o__Lactobacillales; f__Enterococcaceae; g__Enterococcus; s__Enterococcus_faecalis
Mockrobiota_215	k__Bacteria; p__Firmicutes; c__Bacilli; o__Lactobacillales; f__Enterococcaceae; g__Enterococcus; s__Enterococcus_faecalis
Mockrobiota_29	k__Bacteria; p__Firmicutes; c__Bacilli; o__Lactobacillales; f__Enterococcaceae; g__Enterococcus; s__Enterococcus_faecalis
Mockrobiota_30	k__Bacteria; p__Firmicutes; c__Bacilli; o__Lactobacillales; f__Enterococcaceae; g__Enterococcus; s__Enterococcus_faecalis
Mockrobiota_216	k__Bacteria; p__Firmicutes; c__Bacilli; o__Lactobacillales; f__Enterococcaceae; g__Enterococcus; s__Enterococcus_faecalis
Mockrobiota_130	k__Bacteria; p__Firmicutes; c__Bacilli; o__Lactobacillales; f__Enterococcaceae; g__Enterococcus; s__Enterococcus_faecalis
Mockrobiota_98	k__Bacteria; p__Bacteroidetes; c__Bacteroidia; o__Bacteroidales; f__Bacteroidaceae; g__Bacteroides; s__Bacteroides_ovatus
Mockrobiota_97	k__Bacteria; p__Bacteroidetes; c__Bacteroidia; o__Bacteroidales; f__Bacteroidaceae; g__Bacteroides; s__Bacteroides_ovatus
Mockrobiota_95	k__Bacteria; p__Bacteroidetes; c__Bacteroidia; o__Bacteroidales; f__Bacteroidaceae; g__Bacteroides; s__Bacteroides_ovatus
Mockrobiota_96	k__Bacteria; p__Bacteroidetes; c__Bacteroidia; o__Bacteroidales; f__Bacteroidaceae; g__Bacteroides; s__Bacteroides_ovatus
Mockrobiota_100	k__Bacteria; p__Bacteroidetes; c__Bacteroidia; o__Bacteroidales; f__Bacteroidaceae; g__Bacteroides; s__Bacteroides_ovatus
Mockrobiota_99	k__Bacteria; p__Bacteroidetes; c__Bacteroidia; o__Bacteroidales; f__Bacteroidaceae; g__Bacteroides; s__Bacteroides_ovatus
Mockrobiota_124	k__Bacteria; p__Proteobacteria; c__Gammaproteobacteria; o__Enterobacterales; f__Pectobacteriaceae; g__Dickeya; s__Dickeya_dadantii
Mockrobiota_123	k__Bacteria; p__Proteobacteria; c__Gammaproteobacteria; o__Enterobacterales; f__Pectobacteriaceae; g__Dickeya; s__Dickeya_dadantii
Mockrobiota_125	k__Bacteria; p__Proteobacteria; c__Gammaproteobacteria; o__Enterobacterales; f__Pectobacteriaceae; g__Dickeya; s__Dickeya_dadantii
Mockrobiota_127	k__Bacteria; p__Proteobacteria; c__Gammaproteobacteria; o__Enterobacterales; f__Pectobacteriaceae; g__Dickeya; s__Dickeya_dadantii
Mockrobiota_126	k__Bacteria; p__Proteobacteria; c__Gammaproteobacteria; o__Enterobacterales; f__Pectobacteriaceae; g__Dickeya; s__Dickeya_dadantii
Mockrobiota_122	k__Bacteria; p__Proteobacteria; c__Gammaproteobacteria; o__Enterobacterales; f__Pectobacteriaceae; g__Dickeya; s__Dickeya_dadantii
Mockrobiota_133	k__Bacteria; p__Fusobacteria; c__Fusobacteriia; o__Fusobacteriales; f__Fusobacteriaceae; g__Fusobacterium; s__Fusobacterium_nucleatum
Mockrobiota_134	k__Bacteria; p__Fusobacteria; c__Fusobacteriia; o__Fusobacteriales; f__Fusobacteriaceae; g__Fusobacterium; s__Fusobacterium_nucleatum
Mockrobiota_132	k__Bacteria; p__Fusobacteria; c__Fusobacteriia; o__Fusobacteriales; f__Fusobacteriaceae; g__Fusobacterium; s__Fusobacterium_nucleatum
Mockrobiota_131	k__Bacteria; p__Fusobacteria; c__Fusobacteriia; o__Fusobacteriales; f__Fusobacteriaceae; g__Fusobacterium; s__Fusobacterium_nucleatum
Mockrobiota_135	k__Bacteria; p__Fusobacteria; c__Fusobacteriia; o__Fusobacteriales; f__Fusobacteriaceae; g__Fusobacterium; s__Fusobacterium_nucleatum
Mockrobiota_136	k__Bacteria; p__Fusobacteria; c__Fusobacteriia; o__Fusobacteriales; f__Fusobacteriaceae; g__Fusobacterium; s__Fusobacterium_nucleatum
Mockrobiota_27	k__Bacteria; p__Deinococcus-Thermus; c__Deinococci; o__Deinococcales; f__Deinococcaceae; g__Deinococcus; s__Deinococcus_radiodurans
Mockrobiota_213	k__Bacteria; p__Deinococcus-Thermus; c__Deinococci; o__Deinococcales; f__Deinococcaceae; g__Deinococcus; s__Deinococcus_radiodurans
Mockrobiota_214	k__Bacteria; p__Deinococcus-Thermus; c__Deinococci; o__Deinococcales; f__Deinococcaceae; g__Deinococcus; s__Deinococcus_radiodurans
Mockrobiota_118	k__Bacteria; p__Deinococcus-Thermus; c__Deinococci; o__Deinococcales; f__Deinococcaceae; g__Deinococcus; s__Deinococcus_radiodurans
Mockrobiota_28	k__Bacteria; p__Deinococcus-Thermus; c__Deinococci; o__Deinococcales; f__Deinococcaceae; g__Deinococcus; s__Deinococcus_radiodurans
Mockrobiota_37	k__Bacteria; p__Proteobacteria; c__Gammaproteobacteria; o__Pseudomonadales; f__Pseudomonadaceae; g__Pseudomonas; s__Pseudomonas_aeruginosa
Mockrobiota_232	k__Bacteria; p__Proteobacteria; c__Gammaproteobacteria; o__Pseudomonadales; f__Pseudomonadaceae; g__Pseudomonas; s__Pseudomonas_aeruginosa
Mockrobiota_233	k__Bacteria; p__Proteobacteria; c__Gammaproteobacteria; o__Pseudomonadales; f__Pseudomonadaceae; g__Pseudomonas; s__Pseudomonas_aeruginosa
Mockrobiota_38	k__Bacteria; p__Proteobacteria; c__Gammaproteobacteria; o__Pseudomonadales; f__Pseudomonadaceae; g__Pseudomonas; s__Pseudomonas_aeruginosa
Mockrobiota_39	k__Bacteria; p__Proteobacteria; c__Gammaproteobacteria; o__Pseudomonadales; f__Pseudomonadaceae; g__Pseudomonas; s__Pseudomonas_aeruginosa
Mockrobiota_104	k__Bacteria; p__Bacteroidetes; c__Bacteroidia; o__Bacteroidales; f__Bacteroidaceae; g__Bacteroides; s__Bacteroides_uniformis
Mockrobiota_105	k__Bacteria; p__Bacteroidetes; c__Bacteroidia; o__Bacteroidales; f__Bacteroidaceae; g__Bacteroides; s__Bacteroides_uniformis
Mockrobiota_107	k__Bacteria; p__Bacteroidetes; c__Bacteroidia; o__Bacteroidales; f__Bacteroidaceae; g__Bacteroides; s__Bacteroides_uniformis
Mockrobiota_103	k__Bacteria; p__Bacteroidetes; c__Bacteroidia; o__Bacteroidales; f__Bacteroidaceae; g__Bacteroides; s__Bacteroides_uniformis
Mockrobiota_106	k__Bacteria; p__Bacteroidetes; c__Bacteroidia; o__Bacteroidales; f__Bacteroidaceae; g__Bacteroides; s__Bacteroides_uniformis
Mockrobiota_230	k__Bacteria; p__Actinobacteria; c__Actinomycetia; o__Propionibacteriales; f__Propionibacteriaceae; g__Cutibacterium; s__Cutibacterium_acnes
Mockrobiota_36	k__Bacteria; p__Actinobacteria; c__Actinomycetia; o__Propionibacteriales; f__Propionibacteriaceae; g__Cutibacterium; s__Cutibacterium_acnes
Mockrobiota_231	k__Bacteria; p__Actinobacteria; c__Actinomycetia; o__Propionibacteriales; f__Propionibacteriaceae; g__Cutibacterium; s__Cutibacterium_acnes
Mockrobiota_35	k__Bacteria; p__Actinobacteria; c__Actinomycetia; o__Propionibacteriales; f__Propionibacteriaceae; g__Cutibacterium; s__Cutibacterium_acnes
Mockrobiota_40	k__Bacteria; p__Proteobacteria; c__Alphaproteobacteria; o__Rhodobacterales; f__Rhodobacteraceae; g__Cereibacter; s__Cereibacter_sphaeroides
Mockrobiota_41	k__Bacteria; p__Proteobacteria; c__Alphaproteobacteria; o__Rhodobacterales; f__Rhodobacteraceae; g__Cereibacter; s__Cereibacter_sphaeroides
Mockrobiota_236	k__Bacteria; p__Proteobacteria; c__Alphaproteobacteria; o__Rhodobacterales; f__Rhodobacteraceae; g__Cereibacter; s__Cereibacter_sphaeroides
Mockrobiota_235	k__Bacteria; p__Proteobacteria; c__Alphaproteobacteria; o__Rhodobacterales; f__Rhodobacteraceae; g__Cereibacter; s__Cereibacter_sphaeroides
Mockrobiota_79	k__Bacteria; p__Bacteroidetes; c__Bacteroidia; o__Bacteroidales; f__Tannerellaceae; g__Parabacteroides; s__Parabacteroides_merdae
Mockrobiota_81	k__Bacteria; p__Bacteroidetes; c__Bacteroidia; o__Bacteroidales; f__Tannerellaceae; g__Parabacteroides; s__Parabacteroides_merdae
Mockrobiota_80	k__Bacteria; p__Bacteroidetes; c__Bacteroidia; o__Bacteroidales; f__Tannerellaceae; g__Parabacteroides; s__Parabacteroides_merdae
Mockrobiota_78	k__Bacteria; p__Bacteroidetes; c__Bacteroidia; o__Bacteroidales; f__Tannerellaceae; g__Parabacteroides; s__Parabacteroides_merdae
Mockrobiota_109	k__Bacteria; p__Bacteroidetes; c__Bacteroidia; o__Bacteroidales; f__Porphyromonadaceae; g__Porphyromonas; s__Porphyromonas_gingivalis
Mockrobiota_153	k__Bacteria; p__Bacteroidetes; c__Bacteroidia; o__Bacteroidales; f__Porphyromonadaceae; g__Porphyromonas; s__Porphyromonas_gingivalis
Mockrobiota_234	k__Bacteria; p__Bacteroidetes; c__Bacteroidia; o__Bacteroidales; f__Porphyromonadaceae; g__Porphyromonas; s__Porphyromonas_gingivalis
Mockrobiota_154	k__Bacteria; p__Bacteroidetes; c__Bacteroidia; o__Bacteroidales; f__Porphyromonadaceae; g__Porphyromonas; s__Porphyromonas_gingivalis
Mockrobiota_53	k__Bacteria; p__Firmicutes; c__Bacilli; o__Lactobacillales; f__Streptococcaceae; g__Streptococcus; s__Streptococcus_mutans
Mockrobiota_247	k__Bacteria; p__Firmicutes; c__Bacilli; o__Lactobacillales; f__Streptococcaceae; g__Streptococcus; s__Streptococcus_mutans
Mockrobiota_246	k__Bacteria; p__Firmicutes; c__Bacilli; o__Lactobacillales; f__Streptococcaceae; g__Streptococcus; s__Streptococcus_mutans
Mockrobiota_52	k__Bacteria; p__Firmicutes; c__Bacilli; o__Lactobacillales; f__Streptococcaceae; g__Streptococcus; s__Streptococcus_mutans
Mockrobiota_72	k__Bacteria; p__Bacteroidetes; c__Bacteroidia; o__Bacteroidales; f__Prevotellaceae; g__Prevotella; s__Prevotella_copri
Mockrobiota_73	k__Bacteria; p__Bacteroidetes; c__Bacteroidia; o__Bacteroidales; f__Prevotellaceae; g__Prevotella; s__Prevotella_copri
Mockrobiota_74	k__Bacteria; p__Bacteroidetes; c__Bacteroidia; o__Bacteroidales; f__Prevotellaceae; g__Prevotella; s__Prevotella_copri
Mockrobiota_92	k__Bacteria; p__Bacteroidetes; c__Bacteroidia; o__Bacteroidales; f__Bacteroidaceae; g__Bacteroides; s__Bacteroides_cellulosilyticus
Mockrobiota_94	k__Bacteria; p__Bacteroidetes; c__Bacteroidia; o__Bacteroidales; f__Bacteroidaceae; g__Bacteroides; s__Bacteroides_cellulosilyticus
Mockrobiota_93	k__Bacteria; p__Bacteroidetes; c__Bacteroidia; o__Bacteroidales; f__Bacteroidaceae; g__Bacteroides; s__Bacteroides_cellulosilyticus
Mockrobiota_120	k__Bacteria; p__Proteobacteria; c__Deltaproteobacteria; o__Desulfovibrionales; f__Desulfovibrionaceae; g__Desulfovibrio; s__Desulfovibrio_piger
Mockrobiota_121	k__Bacteria; p__Proteobacteria; c__Deltaproteobacteria; o__Desulfovibrionales; f__Desulfovibrionaceae; g__Desulfovibrio; s__Desulfovibrio_piger
Mockrobiota_119	k__Bacteria; p__Proteobacteria; c__Deltaproteobacteria; o__Desulfovibrionales; f__Desulfovibrionaceae; g__Desulfovibrio; s__Desulfovibrio_piger
Mockrobiota_139	k__Bacteria; p__Chloroflexi; c__Chloroflexia; o__Herpetosiphonales; f__Herpetosiphonaceae; g__Herpetosiphon; s__Herpetosiphon_aurantiacus
Mockrobiota_138	k__Bacteria; p__Chloroflexi; c__Chloroflexia; o__Herpetosiphonales; f__Herpetosiphonaceae; g__Herpetosiphon; s__Herpetosiphon_aurantiacus
Mockrobiota_140	k__Bacteria; p__Chloroflexi; c__Chloroflexia; o__Herpetosiphonales; f__Herpetosiphonaceae; g__Herpetosiphon; s__Herpetosiphon_aurantiacus
Mockrobiota_149	k__Bacteria; p__Chlorobi; c__Chlorobia; o__Chlorobiales; f__Chlorobiaceae; g__Pelodictyon; s__Pelodictyon_phaeoclathratiforme
Mockrobiota_150	k__Bacteria; p__Chlorobi; c__Chlorobia; o__Chlorobiales; f__Chlorobiaceae; g__Pelodictyon; s__Pelodictyon_phaeoclathratiforme
Mockrobiota_151	k__Bacteria; p__Chlorobi; c__Chlorobia; o__Chlorobiales; f__Chlorobiaceae; g__Pelodictyon; s__Pelodictyon_phaeoclathratiforme
Mockrobiota_182	k__Bacteria; p__Thermotogae; c__Thermotogae; o__Thermotogales; f__Thermotogaceae; g__Thermotoga; s__Thermotoga_neapolitana-petrophila
Mockrobiota_181	k__Bacteria; p__Thermotogae; c__Thermotogae; o__Thermotogales; f__Thermotogaceae; g__Thermotoga; s__Thermotoga_neapolitana-petrophila
Mockrobiota_180	k__Bacteria; p__Thermotogae; c__Thermotogae; o__Thermotogales; f__Thermotogaceae; g__Thermotoga; s__Thermotoga_neapolitana-petrophila
Mockrobiota_223	k__Bacteria; p__Proteobacteria; c__Epsilonproteobacteria; o__Campylobacterales; f__Helicobacteraceae; g__Helicobacter; s__Helicobacter_pylori
Mockrobiota_32	k__Bacteria; p__Proteobacteria; c__Epsilonproteobacteria; o__Campylobacterales; f__Helicobacteraceae; g__Helicobacter; s__Helicobacter_pylori
Mockrobiota_60	k__Archaea; p__Euryarchaeota; c__Methanobacteria; o__Methanobacteriales; f__Methanobacteriaceae; g__Methanobrevibacter; s__Methanobrevibacter_smithii
Mockrobiota_61	k__Archaea; p__Euryarchaeota; c__Methanobacteria; o__Methanobacteriales; f__Methanobacteriaceae; g__Methanobrevibacter; s__Methanobrevibacter_smithii
Mockrobiota_1	k__Bacteria; p__Proteobacteria; c__Gammaproteobacteria; o__Moraxellales; f__Moraxellaceae; g__Acinetobacter; s__Acinetobacter_baumannii
Mockrobiota_188	k__Bacteria; p__Proteobacteria; c__Gammaproteobacteria; o__Moraxellales; f__Moraxellaceae; g__Acinetobacter; s__Acinetobacter_baumannii
Mockrobiota_224	k__Bacteria; p__Firmicutes; c__Bacilli; o__Lactobacillales; f__Lactobacillaceae; g__Lactobacillus; s__Lactobacillus_gasseri
Mockrobiota_33	k__Bacteria; p__Firmicutes; c__Bacilli; o__Lactobacillales; f__Lactobacillaceae; g__Lactobacillus; s__Lactobacillus_gasseri
Mockrobiota_229	k__Bacteria; p__Proteobacteria; c__Betaproteobacteria; o__Neisseriales; f__Neisseriaceae; g__Neisseria; s__Neisseria_meningitidis
Mockrobiota_34	k__Bacteria; p__Proteobacteria; c__Betaproteobacteria; o__Neisseriales; f__Neisseriaceae; g__Neisseria; s__Neisseria_meningitidis
Mockrobiota_244	k__Bacteria; p__Firmicutes; c__Bacilli; o__Bacillales; f__Staphylococcaceae; g__Staphylococcus; s__Staphylococcus_epidermidis
Mockrobiota_50	k__Bacteria; p__Firmicutes; c__Bacilli; o__Bacillales; f__Staphylococcaceae; g__Staphylococcus; s__Staphylococcus_epidermidis
Mockrobiota_62	k__Bacteria; p__Bacteroidetes; c__Bacteroidia; o__Bacteroidales; f__Tannerellaceae; g__Parabacteroides; s__Parabacteroides_distasonis
Mockrobiota_69	k__Bacteria; p__Bacteroidetes; c__Bacteroidia; o__Bacteroidales; f__Tannerellaceae; g__Parabacteroides; s__Parabacteroides_distasonis
Mockrobiota_64	k__Bacteria; p__Bacteroidetes; c__Bacteroidia; o__Bacteroidales; f__Barnesiellaceae; g__Barnesiella; s__Barnesiella_intestinihominis
Mockrobiota_63	k__Bacteria; p__Bacteroidetes; c__Bacteroidia; o__Bacteroidales; f__Barnesiellaceae; g__Barnesiella; s__Barnesiella_intestinihominis
Mockrobiota_75	k__Bacteria; p__Firmicutes; c__Clostridia; o__Eubacteriales; f__Lachnospiraceae; g__[Ruminococcus]_gnavus_group; s__[Ruminococcus]_gnavus
Mockrobiota_76	k__Bacteria; p__Firmicutes; c__Clostridia; o__Eubacteriales; f__Lachnospiraceae; g__[Ruminococcus]_gnavus_group; s__[Ruminococcus]_gnavus
Mockrobiota_84	k__Bacteria; p__Firmicutes; c__Clostridia; o__Eubacteriales; f__Lachnospiraceae; g__Coprococcus; s__Coprococcus_comes
Mockrobiota_83	k__Bacteria; p__Firmicutes; c__Clostridia; o__Eubacteriales; f__Lachnospiraceae; g__Coprococcus; s__Coprococcus_comes
Mockrobiota_86	k__Bacteria; p__Bacteroidetes; c__Bacteroidia; o__Bacteroidales; f__Bacteroidaceae; g__Bacteroides; s__Bacteroides_thetaiotaomicron
Mockrobiota_87	k__Bacteria; p__Bacteroidetes; c__Bacteroidia; o__Bacteroidales; f__Bacteroidaceae; g__Bacteroides; s__Bacteroides_thetaiotaomicron
Mockrobiota_91	k__Bacteria; p__Firmicutes; c__Clostridia; o__Oscillospirales; f__[Clostridium]_methylpentosum_group; g__[Clostridium]_methylpentosum_group; s__[Clostridium]_methylpentosum
Mockrobiota_90	k__Bacteria; p__Firmicutes; c__Clostridia; o__Oscillospirales; f__[Clostridium]_methylpentosum_group; g__[Clostridium]_methylpentosum_group; s__[Clostridium]_methylpentosum
Mockrobiota_111	k__Bacteria; p__Verrucomicrobia; c__Verrucomicrobiae; o__Verrucomicrobiales; f__Akkermansiaceae; g__Akkermansia; s__Akkermansia_muciniphila
Mockrobiota_112	k__Bacteria; p__Verrucomicrobia; c__Verrucomicrobiae; o__Verrucomicrobiales; f__Akkermansiaceae; g__Akkermansia; s__Akkermansia_muciniphila
Mockrobiota_262	k__Bacteria; p__Chloroflexi; c__Chloroflexia; o__Chloroflexales; f__Chloroflexaceae; g__Chloroflexus; s__Chloroflexus_aurantiacus
Mockrobiota_117	k__Bacteria; p__Chloroflexi; c__Chloroflexia; o__Chloroflexales; f__Chloroflexaceae; g__Chloroflexus; s__Chloroflexus_aurantiacus
Mockrobiota_252	k__Bacteria; p__Gemmatimonadetes; c__Gemmatimonadetes; o__Gemmatimonadales; f__Gemmatimonadaceae; g__Gemmatimonas; s__Gemmatimonas_aurantiaca
Mockrobiota_137	k__Bacteria; p__Gemmatimonadetes; c__Gemmatimonadetes; o__Gemmatimonadales; f__Gemmatimonadaceae; g__Gemmatimonas; s__Gemmatimonas_aurantiaca
Mockrobiota_144	k__Archaea; p__Euryarchaeota; c__Methanococci; o__Methanococcales; f__Methanocaldococcaceae; g__Methanocaldococcus; s__Methanocaldococcus_jannaschii
Mockrobiota_143	k__Archaea; p__Euryarchaeota; c__Methanococci; o__Methanococcales; f__Methanocaldococcaceae; g__Methanocaldococcus; s__Methanocaldococcus_jannaschii
Mockrobiota_145	k__Archaea; p__Euryarchaeota; c__Methanococci; o__Methanococcales; f__Methanococcaceae; g__Methanococcus; s__Methanococcus_maripaludis
Mockrobiota_146	k__Archaea; p__Euryarchaeota; c__Methanococci; o__Methanococcales; f__Methanococcaceae; g__Methanococcus; s__Methanococcus_maripaludis
Mockrobiota_250	k__Bacteria; p__Proteobacteria; c__Betaproteobacteria; o__Nitrosomonadales; f__Nitrosomonadaceae; g__Nitrosomonas; s__Nitrosomonas_europaea
Mockrobiota_148	k__Bacteria; p__Proteobacteria; c__Betaproteobacteria; o__Nitrosomonadales; f__Nitrosomonadaceae; g__Nitrosomonas; s__Nitrosomonas_europaea
Mockrobiota_156	k__Archaea; p__Crenarchaeota; c__Thermoprotei; o__Thermoproteales; f__Thermoproteaceae; g__Pyrobaculum; s__Pyrobaculum_aerophilum-calidifontis
Mockrobiota_155	k__Archaea; p__Crenarchaeota; c__Thermoprotei; o__Thermoproteales; f__Thermoproteaceae; g__Pyrobaculum; s__Pyrobaculum_aerophilum-calidifontis
Mockrobiota_161	k__Bacteria; p__Actinobacteria; c__Actinomycetia; o__Micromonosporales; f__Micromonosporaceae; g__Salinispora; s__Salinispora_arenicola-tropica
Mockrobiota_160	k__Bacteria; p__Actinobacteria; c__Actinomycetia; o__Micromonosporales; f__Micromonosporaceae; g__Salinispora; s__Salinispora_arenicola-tropica
Mockrobiota_179	k__Bacteria; p__Aquificae; c__Aquificae; o__Aquificales; f__Hydrogenothermaceae; g__Sulfurihydrogenibium; s__Sulfurihydrogenibium_yellowstonense
Mockrobiota_178	k__Bacteria; p__Aquificae; c__Aquificae; o__Aquificales; f__Hydrogenothermaceae; g__Sulfurihydrogenibium; s__Sulfurihydrogenibium_yellowstonense
Mockrobiota_184	k__Bacteria; p__Spirochaetes; c__Spirochaetia; o__Spirochaetales; f__Treponemataceae; g__Treponema; s__Treponema_denticola
Mockrobiota_185	k__Bacteria; p__Spirochaetes; c__Spirochaetia; o__Spirochaetales; f__Treponemataceae; g__Treponema; s__Treponema_denticola
Mockrobiota_245	k__Bacteria; p__Firmicutes; c__Bacilli; o__Lactobacillales; f__Streptococcaceae; g__Streptococcus; s__Streptococcus_agalactiae
Mockrobiota_51	k__Bacteria; p__Firmicutes; c__Bacilli; o__Lactobacillales; f__Streptococcaceae; g__Streptococcus; s__Streptococcus_agalactiae
Mockrobiota_54	k__Bacteria; p__Firmicutes; c__Bacilli; o__Lactobacillales; f__Streptococcaceae; g__Streptococcus; s__Streptococcus_pneumoniae
Mockrobiota_248	k__Bacteria; p__Firmicutes; c__Bacilli; o__Lactobacillales; f__Streptococcaceae; g__Streptococcus; s__Streptococcus_pneumoniae
Mockrobiota_113	k__Archaea; p__Euryarchaeota; c__Archaeoglobi; o__Archaeoglobales; f__Archaeoglobaceae; g__Archaeoglobus; s__Archaeoglobus_fulgidus
Mockrobiota_147	k__Archaea; p__Nanoarchaeota; c__Candidatus_Nanoarchaeia; o__Nanoarchaeales; f__Nanoarchaeaceae; g__Nanoarchaeum; s__Nanoarchaeum_equitans
Mockrobiota_157	k__Archaea; p__Euryarchaeota; c__Thermococci; o__Thermococcales; f__Thermococcaceae; g__Pyrococcus; s__Pyrococcus_horikoshii
Mockrobiota_55	k__Bacteria; p__Actinobacteria; c__Actinomycetia; o__Actinomycetales; f__Actinomycetaceae; g__Actinomyces; s__Actinomyces_odontolyticus
Mockrobiota_70	k__Bacteria; p__Firmicutes; c__Clostridia; o__Eubacteriales; f__Unknown; g__Howardella; s__Howardella_ureilytica
Mockrobiota_71	k__Bacteria; p__Firmicutes; c__Clostridia; o__Eubacteriales; f__Lachnospiraceae; g__Roseburia; s__Roseburia_inulinivorans
Mockrobiota_77	k__Bacteria; p__Firmicutes; c__Clostridia; o__Eubacteriales; f__Clostridiaceae; g__Clostridium_sensu_stricto_1; s__Clostridium_sensu
Mockrobiota_82	k__Bacteria; p__Bacteroidetes; c__Bacteroidia; o__Bacteroidales; f__Bacteroidaceae; g__Phocaeicola; s__Phocaeicola_massiliensis
Mockrobiota_88	k__Bacteria; p__Bacteroidetes; c__Bacteroidia; o__Bacteroidales; f__Prevotellaceae; g__Prevotella; s__Prevotella_buccalis
Mockrobiota_102	k__Bacteria; p__Bacteroidetes; c__Bacteroidia; o__Bacteroidales; f__Bacteroidaceae; g__Bacteroides; s__Bacteroides_fragilis
Mockrobiota_108	k__Bacteria; p__Bacteroidetes; c__Bacteroidia; o__Bacteroidales; f__Bacteroidaceae; g__Bacteroides; s__Bacteroides_eggerthii
Mockrobiota_110	k__Bacteria; p__Acidobacteria; c__Acidobacteriia; o__Acidobacteriales; f__Acidobacteriaceae; g__Acidobacterium; s__Acidobacterium_capsulatum
Mockrobiota_114	k__Bacteria; p__Proteobacteria; c__Betaproteobacteria; o__Burkholderiales; f__Alcaligenaceae; g__Bordetella; s__Bordetella_bronchiseptica
Mockrobiota_115	k__Bacteria; p__Proteobacteria; c__Betaproteobacteria; o__Burkholderiales; f__Burkholderiaceae; g__Burkholderia-Caballeronia-Paraburkholderia; s__Burkholderia-Caballeronia-Paraburkholderia_xenovorans
Mockrobiota_116	k__Bacteria; p__Firmicutes; c__Clostridia; o__Thermoanaerobacterales; f__Thermoanaerobacterales_Family_III._Incertae_Sedis; g__Caldicellulosiruptor; s__Caldicellulosiruptor_bescii
Mockrobiota_128	k__Bacteria; p__Dictyoglomi; c__Dictyoglomia; o__Dictyoglomales; f__Dictyoglomaceae; g__Dictyoglomus; s__Dictyoglomus_turgidum
Mockrobiota_141	k__Archaea; p__Crenarchaeota; c__Thermoprotei; o__Desulfurococcales; f__Desulfurococcaceae; g__Ignicoccus; s__Ignicoccus_hospitalis
Mockrobiota_142	k__Bacteria; p__Proteobacteria; c__Betaproteobacteria; o__Burkholderiales; f__Unknown; g__Leptothrix; s__Leptothrix_cholodnii
Mockrobiota_152	k__Bacteria; p__Aquificae; c__Aquificae; o__Aquificales; f__Hydrogenothermaceae; g__Persephonella; s__Persephonella_marina
Mockrobiota_158	k__Bacteria; p__Planctomycetes; c__Planctomycetia; o__Pirellulales; f__Pirellulaceae; g__Rhodopirellula; s__Rhodopirellula_baltica
Mockrobiota_159	k__Bacteria; p__Proteobacteria; c__Alphaproteobacteria; o__Rhodobacterales; f__Roseobacteraceae; g__Ruegeria; s__Ruegeria_pomeroyi
Mockrobiota_177	k__Archaea; p__Crenarchaeota; c__Thermoprotei; o__Sulfolobales; f__Sulfolobaceae; g__Sulfurisphaera; s__Sulfurisphaera_tokodaii
Mockrobiota_183	k__Bacteria; p__Deinococcus-Thermus; c__Deinococci; o__Thermales; f__Thermaceae; g__Thermus; s__Thermus_thermophilus
Mockrobiota_186	k__Bacteria; p__Spirochaetes; c__Spirochaetia; o__Spirochaetales; f__Treponemataceae; g__Treponema; s__Treponema_vincentii
Mockrobiota_187	k__Bacteria; p__Proteobacteria; c__Alphaproteobacteria; o__Sphingomonadales; f__Zymomonadaceae; g__Zymomonas; s__Zymomonas_mobilis
Mockrobiota_249	k__Bacteria; p__Proteobacteria; c__Alphaproteobacteria; o__Hyphomicrobiales; f__Nitrobacteraceae; g__Nitrobacter; s__Nitrobacter_winogradskyi
Mockrobiota_251	k__Bacteria; p__Proteobacteria; c__Gammaproteobacteria; o__Pseudomonadales; f__Pseudomonadaceae; g__Pseudomonas; s__Pseudomonas_putida
Mockrobiota_253	k__Bacteria; p__Firmicutes; c__Bacilli; o__Bacillales; f__Bacillaceae; g__Bacillus; s__Bacillus_subtilis
Mockrobiota_254	k__Bacteria; p__Proteobacteria; c__Deltaproteobacteria; o__Desulfovibrionales; f__Desulfovibrionaceae; g__Desulfovibrio; s__Desulfovibrio_vulgaris
Mockrobiota_255	k__Bacteria; p__Firmicutes; c__Clostridia; o__Eubacteriales; f__Clostridiaceae; g__Clostridium_sensu_stricto_11; s__Clostridium_sensu
Mockrobiota_256	k__Bacteria; p__Actinobacteria; c__Actinomycetia; o__Propionibacteriales; f__Propionibacteriaceae; g__Microlunatus; s__Microlunatus_phosphovorus
Mockrobiota_257	k__Bacteria; p__Chloroflexi; c__Anaerolineae; o__Anaerolineales; f__Anaerolineaceae; g__Pelolinea; s__Pelolinea_thermophila
Mockrobiota_258	k__Bacteria; p__Spirochaetes; c__Spirochaetia; o__Spirochaetales; f__Treponemataceae; g__Treponema; s__Treponema_bryantii
Mockrobiota_259	k__Bacteria; p__Deinococcus-Thermus; c__Deinococci; o__Deinococcales; f__Deinococcaceae; g__Deinococcus; s__Deinococcus_grandis
Mockrobiota_263	k__Bacteria; p__Firmicutes; c__Clostridia; o__Eubacteriales; f__Desulfitobacteriaceae; g__Desulfitobacterium; s__Desulfitobacterium_hafniense
Mockrobiota_264	k__Bacteria; p__Proteobacteria; c__Gammaproteobacteria; o__Enterobacterales; f__Enterobacteriaceae; g__Escherichia; s__Escherichia_coli
Mockrobiota_265	k__Bacteria; p__Proteobacteria; c__Gammaproteobacteria; o__Enterobacterales; f__Enterobacteriaceae; g__Escherichia; s__Escherichia_coli
Mockrobiota_266	k__Bacteria; p__Proteobacteria; c__Gammaproteobacteria; o__Enterobacterales; f__Enterobacteriaceae; g__Escherichia; s__Escherichia_coli
Mockrobiota_267	k__Bacteria; p__Proteobacteria; c__Gammaproteobacteria; o__Enterobacterales; f__Enterobacteriaceae; g__Escherichia; s__Escherichia_coli
Mockrobiota_268	k__Bacteria; p__Proteobacteria; c__Gammaproteobacteria; o__Enterobacterales; f__Enterobacteriaceae; g__Escherichia; s__Escherichia_coli
Mockrobiota_269	k__Bacteria; p__Proteobacteria; c__Gammaproteobacteria; o__Enterobacterales; f__Enterobacteriaceae; g__Escherichia; s__Escherichia_coli
Mockrobiota_270	k__Bacteria; p__Proteobacteria; c__Gammaproteobacteria; o__Enterobacterales; f__Enterobacteriaceae; g__Escherichia; s__Escherichia_coli
Mockrobiota_271	k__Bacteria; p__Proteobacteria; c__Gammaproteobacteria; o__Enterobacterales; f__Enterobacteriaceae; g__Escherichia; s__Escherichia_coli
Mockrobiota_272	k__Bacteria; p__Bacteroidetes; c__Bacteroidia; o__Bacteroidales; f__Bacteroidaceae; g__Phocaeicola; s__Phocaeicola_vulgatus
Mockrobiota_273	k__Bacteria; p__Firmicutes; c__Clostridia; o__Eubacteriales; f__Clostridiaceae; g__Clostridium_sensu_stricto_11; s__Clostridium_sensu
Mockrobiota_274	k__Bacteria; p__Spirochaetes; c__Spirochaetia; o__Spirochaetales; f__Treponemataceae; g__Treponema; s__Treponema_bryantii
Mockrobiota_85	k__Bacteria; p__Bacteroidetes; c__Bacteroidia; o__Bacteroidales; f__Bacteroidaceae; g__Bacteroides; s__Bacteroides_thetaiotaomicron
Mockrobiota_89	k__Bacteria; p__Firmicutes; c__Erysipelotrichia; o__Erysipelotrichales; f__Erysipelotrichaceae; g__Erysipelatoclostridium; s__[Clostridium]_cocleatum
Mockrobiota_101	k__Bacteria; p__Bacteroidetes; c__Bacteroidia; o__Bacteroidales; f__Prevotellaceae; g__Paraprevotella; s__Paraprevotella_clara
